[level]
map = --------
      --------
      --------
      --------
      --------
      --------
      --------
      x-------

[-]
name = blank

[x]
name = unit
block = true